[
    [13,13],
    [6,11],
    [
        [[6,5],"lorelei", 1, ["dewgong", "cloyster", "slowbro", "jynx", "lapras"]]
    ],
    [
        [1,1,1,1,1,1,1,1,1,1,1,1,1],
        [1,1,1,1,1,1,1,1,1,1,1,1,1],
        [1,1,1,1,1,1,1,1,1,1,1,1,1],
        [1,0,1,0,0,0,0,0,0,0,1,0,1],
        [1,0,0,0,0,0,0,0,0,0,0,0,1],
        [1,0,1,0,0,0,0,0,0,0,1,0,1],
        [1,0,1,0,0,0,0,0,0,0,1,0,1],
        [1,0,0,0,0,0,0,0,0,0,0,0,1],
        [1,0,1,0,0,0,0,0,0,0,1,0,1],
        [1,0,1,0,0,0,0,0,0,0,1,0,1],
        [1,0,0,0,0,0,0,0,0,0,0,0,1],
        [1,1,1,1,1,1,1,1,1,1,1,1,1],
        [1,1,1,1,1,1,1,1,1,1,1,1,1]
    ]
]